XXXXXXXXXXXXXXXXXXXXXXXXXXXXXXXXXXXXXXXXXXXXXXXXXXXXXXXXXXX
X  @        X                                             X
X         X X                                             X
X         X X                                             X
X         X                                               X
XXXXXXXXX X                                               X
X                                                         X
X                                                         X
X                                                         X
X                                                         X
X                                                         X
X                                                         X
X                                                         X
X                                                         X
X                                                         X
X                                                         X
X                                                         X
X                                                         X
X                                                         X
X                                                         X
X                                                         X
X                                                         X
X                                                         X
X                                                         X
X                                                         X
XXXXXXXXXXXXXXXXXXXXXXXXXXXXXXXXXXXXXXXXXXXXXXXXXXXXXXXXXXX
